+-------------------------------------------------------------------------------------------------------+
|                                                                                                       |
|                                                                                                       |
|                                                                                                       |
|                                                                                                       |
|                                                                                                       |
|                                                                                                       |
|                                                                                                       |
|                                                                                                       |
|                                                                                                       |
|                                                                                                       |
|                                                                                                       |
|                                                                                                       |
|                                                                                                       |
|                                                                                                       |
|                                            L E V E L  1                                               |
|                                                                                                       |
|                                                                                                       |
|                                                                                                       |
|                                                                                                       |
|                                                                                                       |
|                                                                                                       |
|                                                                                                       |
|                                                                                                       |
|                                                                                                       |
|                                                                                                       |
|                                                                                                       |
|                                                                                                       |
|                                                                                                       |
|                                                                                                       |
|                                                                                                       |
|                                                                                                       |
+-------------------------------------------------------------------------------------------------------+
